    wwwww           
    w   w           
    wb  w           
  www  bwww         
  w  b b  w         
www w ww  w   wwwwww
w   w ww  wwwww  ddw
w b  b           ddw
wwwwww www wpww  ddw
     w     wwwwwwwww
     wwwwwww        
